! Kilobolt Studios
! http://kilobolt.com
! Game Development Tutorial - Unit 3
! Q-Bot Level 1
! # = Tile Legend 
! 5 = TileDirt
! 8 = GrassTop
! 2 = GrassBot
! 4 = GrassLeft
! 6 = GrassRight
5555555555555555555555555555555555555555555555555555555555555555555555555555555555555555555555555555555555555555555555555555555
2222222222222222222222222222222222222555555555555555555222222222222222222222222222222222222222222222222222222222222222222222222
6                                    555555555555555555                                                                       4
6                                    222222222222222222                                                                       4
6                                                                                                                             4
6                                                                                                                             4
6                                                                                                                             4
6                                                                                                                             4
6                                                                                                                             4
6                                                                                                                             4
6                                                                                                                             4
6                                                                                                                             4
6                                                                                                                             4
6                                                                                                                             4
6                                                                                                                             4
6                                                                                                                             4
6                                                                                                                             4
6                                                                                                                             4
6                                                                                                                             4
6                                                                                                                   9         4
6                         1                      1                                        1                                   4
6                                   88                              88                                                        4
6                                   46                              46                                                        4
6                                   46                              46                                                        4
5888888888888888888888888888888888885588888888888888888888888888888855888888888888888888888888888888888888888888888888888888885
5555555555555555555555555555555555555555555555555555555555555555555555555555555555555555555555555555555555555555555555555555555
5555555555555555555555555555555555555555555555555555555555555555555555555555555555555555555555555555555555555555555555555555555